0 0 0 0 0 0 0 0 0 0 0 0 0 0 0 0 0 0 0 0
0 0 0 0 0 0 0 0 0 0 0 0 0 0 0 0 0 0 0 0
0 0 0 0 0 0 0 0 0 0 0 0 0 0 0 0 0 0 0 0
0 0 0 0 0 0 0 0 0 0 0 0 0 0 0 0 0 0 0 0
0 0 0 0 0 0 0 0 0 0 0 0 0 0 0 0 0 0 0 0
0 0 0 0 0 0 0 0 0 0 0 0 0 0 0 0 0 0 0 0
0 0 0 0 0 0 0 0 0 0 0 0 0 0 0 0 0 0 0 0
0 0 0 0 0 0 0 0 0 0 0 0 0 0 0 0 0 0 6 0
0 0 0 0 0 0 0 8 9 0 0 0 0 0 0 0 0 0 5 0
0 0 0 0 1 0 0 8 9 0 0 0 0 0 0 0 0 1 1 0
0 0 0 0 0 0 0 8 9 0 0 0 0 0 0 0 0 0 0 0
1 1 1 7 7 7 7 8 9 7 7 7 1 1 1 7 7 7 7 7